Last one standing -- Skylar Grey
Nos plus belles années -- Grand Corps Malade
Cold Heart -- Elton John & Dua Lipa
Wrecked -- Imagine Dragons
Santé -- Stromae
Dynamite -- Sean Paul & Sia
Easy on me -- Adele
Take my breath single version -- The Weeknd
Levitating -- Dua Lipa
Shallow -- Lady Gaga
Hurricane -- Ofenbach
Prends ma main -- Gims et Vitaa
Dans mes bras -- Kendji et Dadju
Où je vais -- Amel Bent, Vitaa & Camélia Jordana
That's what I want -- Lil Nas X
Rétine -- Amir
XY -- Vitaa & Slimane
Pepas -- Farruko
Bruxelles je t'aime -- Angèle
Acapulco -- Jason Derulo
Nos lendemains -- Vianney
Fantôme -- Imen Es
Forrest -- Soprano
Évidemment -- Kendji
Enemy -- Imagine Dragons
Footprints -- Tom Gregory
Woman -- Doja Cat
Heat waves -- Glass Animals
Tornade -- Louane
Unstoppable -- Sia
All I want for Christmas
À la vie qu'on mène -- Jérémy Frérot
Time Time -- Trei Degete
My Universe -- Coldplay & BTS
Dry Bones -- Gregory Porter
Thunder -- Gabry Ponte & Lum!x
just give me a reason pink
moth to a flame the weeknd
sacrifice the weeknd
dodo -- tayc
abcdefu -- gayle
goodbye -- dadju
à la vie qu'on mène -- jérémy frérot
heat waves -- glass animals
my universe -- coldplay bts
unstoppable -- sia
la recette -- slimane
cheap thrills -- sia
calm down -- rema
toko toko -- dadju ronisia
clap your hands -- kungs
hold my hand -- lady gaga
baila -- kendji soolking
2step -- ed sheeran
bones -- imagine dragons
sharks -- imagine dragons
trompeta -- willy william
j'ai la mer -- jérémy frérot
outété -- keen'v
ce soir -- amir
4 u -- ofenbach
suavemente -- soolking
libre -- angèle
mon roi -- camélia jordana
crazy what love can do -- ella henderson
running up that hill -- boris way
santa maria -- ridsa
beggin -- maneskin
clic clic pan pan -- yanns
as it was -- harry styles
bam bam -- camila cabello ed sheeran
potion -- calvin harris dua lipa
middle of the night -- elley duhé
heat waves -- glass animals
dançarina -- pedro sampaio dadju
irrelevant -- pink
less than zero -- the weeknd
21 reasons -- nathan dawe
amore e capoeira -- takagi ketra giusy ferreri
maintenant -- gims
olé -- ridsa
courage to change -- sia
dusk till dawn -- zayn sia
ne pars pas -- keen'v
grandir -- black m amir
